Monsieur et madame : 
M et Mme Aba ont un fils : Bart
M et Mme Abipu ont un fils : César
M et Mme Adlavy Yadlespoir ont un fils : Tanguy
M et Mme Adonaideux ont un fils : Hermann
M et Mme Adrouille Toultan ont un fils : Yves
M et Mme Adessin ont une fille : Blanche
M et Mme Aijeunesse ont un fils : Raoul
M et Mme Aivomindla ont une fille : Charlotte
M et Mme Al Apoubayl ont un fils : Ahmed
M et Mme Amar Takaldir ont un fils : Quentin
M et Mme Amoicesibon ont une fille : Armelle
M et Mme Assin ont un fils : Marc
M et Mme Assonmek ont un fils : Fidel
M et Mme Ateur ont un fils : Nordine
M et Mme Aubin ont une fille : Marie
M et Mme Avudotre ont deux fille : Ella Nadège
M et Mme Balmasquez ont un fils : Alonzo
M et Mme Bansyla ont un fils : Carry
M et Mme Béb&egrav;que ont une fille : Nadine
M et Mme Belande ont un fils : Yves
M et Mme Beurgueur ont un fils : Cochise
M et Mme Bibach ont un fils : Al
M et Mme Bienuncassecroute ont un fils : Humphrey
M et Mme Bistaffaire ont un fils : et bien, César
M et Mme Bistrotjaisoif ont un fils : Alonzo
M et Mme Blouson ont un fils : Jean-Philemon
M et Mme Boitam ont une fille : Alice
M et Mme Bonbeur ont un fils : Jean
M et Mme Bonnehiadaitosse ont une fille : Alice
M et Mme Bromasseurnemarchepamélédoi ont une fille : Sylvie
M et Mme Bromaceurmarchpa Talaidoi : Sylvie
M et Mme Ceheff Sey Pocybl ont un fils : Hassan
M et Mme Chmonfrir ont un fils : Thierry
M et Mme Cochet ont un fils : Eric
M et Mme Collin ont un fils : Julian
M et Mme Condit ont un fils : Wenceslas
M et Mme Connery : Arétha
M et Mme Croque ont une fille : Odile
M et Mme Crue Cuit ont deux fils : Bruno et Bruno
M et Mme Cuch ont un fils : Armand (lire à l'envers)
M et Mme Culelptitfi ont un fils : Roberto
M et Mme Cussonnet-Torelleur ont un fils : Simon
M et Mme D'Huryne ont une fille : Anna-Lise
M et Mme D'sonnett ont un fils : Gordon
M et Mme D'zeuclok ont un fils : Haroun
M et Mme Dalors ont un fils : Omer
M et Mme Danltas ont un fils : Alphonse
M et Mme Danstoncostumeneufmonfils ont un fils : Thibaud
M et Mme Dapart ont un fils : Alban
M et Mme Daprelat ont un fils : Maxime
M et Mme Decok ont un fils : Basile
M et Mme DeHurlevent ont un fils : Léo
M et Mme DelunaMaubeuge ont une fille :C laire
M et Mme Dentavoiturpourpaslassalir ont un fils : Amadéus
M et Mme Deuxfoixparsemaine ont un fils : Yannick
M et Mme Devaiselle ont une fille : Aude
M et Mme Diobète ont une fille : Sally
M et Mme Dioci ont une fille : Kelly
M et Mme Diotte ont une fille : Kelly
M et Mme Dlilacouverturegratte ont une fille : Sandra
M et Mme Doeuf ont un fils : John
M et Mme Donctoilabas ont un fils : Eddy
M et Mme Draissamaire-Pourune-Biaire ont un fils : Ivan
M et Mme Ductombkanltrainpassyamilmor ont une fille : Sylvia
M et Mme Duketchup-Dansmesfrites ont un fils : Jérémy
M et Mme Durdanljardin ont une fille : Sabine
M et Mme Dutrainpourdireaurevoir ont une fille : Alphonsine
M et Mme Duveldyv ont un fils : Ralph
M et Mme Eipan ont un fils : Ahmed
M et Mme Ellahoresteencoredansmesbras ont une fille : Marine
M et Mme Enchier ont un fils : Yvon
M et Mme Enchier ont une fille : Eva
M et Mme Encieux-Ertelapraimidi ont une fille : Cécile
M et Mme Encorsaiquilaipamort ont une fille Sylvie
M et Mme Enfaillite ont une fille : Mélusine
M et Mme Enfant ont deux filles Hélène et Ludivine
M et Mme Eoudchouhinegomme ont un fils : Al
M et Mme Ergébel ont un fils : Octave
M et Mme Erraplu de Sito ont un fils : Olive
M et Mme Eparbal ont un fils : Gilles
M et Mme Etiré Ilfoleuboar ont un fils : Sylvain
M et Mme Eu't Maronne ont un fils : Armand
M et Mme Eu't Maronne ont un fils : Raymond
M et Mme Fairedumal ont une fille : Yvette
M et Mme Féchier ont un fils : Akim
M et Mme Femalh on un fils : Akim
M et Mme Fonfec ont une fille : Sophie
M et Mme Frigoskeutapri ont un fils : Roméo
M et Mme Froid ont 4 filles et 3 fils : Eva, Aude, Anne, Marc, Samson, Paulo et Laura
M et Mme Froid ont 4 filles et 3 fils : Eva, Aude, Anne, Marc, Samson, Gilles et Ella
M et Mme Gingras ont un fils : Yoland
M et Mme Gol ont un fils : Henry
M et Mme Goladetaidetaille ont un fils : Larry
M et Mme Groise d'Enmonpieu ont un fils : Gédéon
M et Mme Groix d'Enmoncanapais ont un fils : Gédéon
M et Mme Hair-Vitemonslip ont un fils : Jean-Philippe
M et Mme Hardelpik ont un fils : Helmut
M et Mme Hare ont une fille : Monica
M et Mme Héa ont une fille : Aline
M et Mme Hekkraz Lehpri ont un fils : Mahmoud
M et Mme Helleboit ont un fils : Elmer
M et Mme Hétamair ont une fille et un fils : Eva et Nick
M et Mme Hokar, de Tours ont un fils : Hademar
M et Mme Honnêon;te ont deux filles : Marie et Camille
M et Mme Hornot'Toby ont un fils : Tobbie
M et Mme Hulet ont deux fils : Yvon et Jacques
M et Mme Idekilahula ont un fils : Ulrich
M et Mme Imitablegoutdelasuze ont une fille : Céline
M et Mme Ison ont un fils : Paco
M et Mme Jemahl-Ales ont un fils : Thomas
M et Mme John ont un fils : Elton
M et Mme Joyeux ont un fils : Noel
M et Mme Jusqualporte ont un fils : Hercule
M et Mme Kapitaine ont un fils : Quel âge a-t-il ?
M et Mme Kart-Postal ont deux fils : Ivan et Dédé
M et Mme Kashtey ont une fille : Sirah
M et Mme Kendetecrevan ont un fils : Louis
M et Mme Kifignol ont 3 filles et 2 fils : Irma, Juste, Rémi, Sabine, Yves, Audrey
M et Mme Kiroule ont un fils : Pierre
M et Mme Kissassoul ont une fille : Louise
M et Mme Kuzbidon ont un fils : Alex
M et Mme LABITE ont deux fils : Aimé et Désiré
M et Mme Lahpay ont un fils : Vishnou
M et Mme Lakouver-Thurmegratt ont une fille : Sandra
M et Mme Lakuice ont un fils : Leilou
M et Mme Lamy ont un fils : Kim
M et Mme Lance ont un fils : Pierre
M et Mme Landemin ont un fils : Roméo
M et Mme Leglas ont un fils : Parkinson
M et Mme Lejouretlanuit ont deux fils : Jacques et André
M et Mme Lepaindelabouche ont un fils : Helmut
M et Mme Letoilepolaire ont une fille : Eléonor
M et Mme Leucepa ont un fils : Judicael
M et Mme Leuzon Y Mankplu K'Limage ont une fille : Zita
M et Mme Liguili ont un fils : Guy
M et Mme Luttefinale ont une fille : Ella
M et Mme Mac Hulotalanvair ont un fils : Jimmy
M et Mme Malauzo ont une fille : Mélanie
M et Mme Marée ont un fils : Conrad
M et Mme Marolex ont une fille : Éléonore
M et Mme Matuer ont un fils : Omar
M et Mme Mavallée ont deux filles : Colette et Berthe
M et Mme Mentpourchien ont un fils : Ali
M et Mme Micoton ont une fille : Mylène
M et Mme Menvussa ont un fils : Gérard
M et Mme Mercedez ont un fils : Roland
M et Mme Metroutilapri ont une fille : Valérie
M et Mme Mieuxavecseslunettes ont une fille : Elvira
M et Mme Mileucouvert ont une fille : Irma
M et Mme Mionben ont une fille : Jessica
M et Mme Moinfor ont un fils : Nelson
M et Mme Moitranquille ont une fille : Alice
M et Mme Mont ont une fille : Marcella
M et Mme Morth ont une fille : Adèle
M et Mme Morve ont un fils : Ivan
M et Mme Mouc ont une fille : Nadine
M et Mme Mouche ont un fils : Ahmed
M et Mme Naidauchaude ont un fils : Roby
M et Mme Naisse ont un fils : Guy
M et Mme Nareff ont deux fils : Michel Paul
M et Mme Ninininininin ont deux fils : Starsky et Hutch
M et Mme Okatar ont une fille tchic tchic car Okatar y n'appella tchictchic
M et Mme Ol ont 5 filles : Jenny, Diane, Beth, Nicole, Ester
M et Mme Onciterne ont une fille : Camille
M et Mme Onestdanl ont un fils : Ahmed
M et Mme Oposte ont un fils : Fidèle
M et Mme Oucesoir ont une fille : Ondine
M et Mme Pallavoisine ont un fils : Jean
M et Mme Pastonzizi on une fille : Nicole
M et Mme Pe'pe'atraverserlarue ont un fils : Edmond
M et Mme Pendulaleur ont une fille : Djemila
M et Mme Peremer ont un fils : Yves-André
M et Mme Perret ont une fille : Inès
M et Mme Pettetaireussi ont une fille : Magali
M et Mme Peulaporte ont deux fils et une fille : Geoffroy, Angèle, Firmin
M et Mme Peurceluila ont un fils : Humphrey
M et Mme Peutropvite ont un fils : Saturnin
M et Mme Pillere ont un fils : Serge
M et Mme Pitivinblanc ont un fils : Ali
M et Mme Ponsable Du Matos ont une fille : Thérèse
M et Mme Porfirlavessel ont un fils : Vladimir
M et Mme Potenpoche ont une fille : Jessica
M et Mme Pourlun et M et Mme Poulotre ont deux fille : Tatiana et Yanna
M et Mme Pourpasalirlavoiture ont un fils : Amadeus
M et Mme Provist ont un fils : Alain
M et Mme Pticoup ont une fille et un fils : Annick, Justin
M et Mme Raeldeutrois ont un fils : Francis
M et Mme Rajtournje-Braak ont une fille : Sylvie
M et Mme Ravaldonctasal ont un fils : Yves
M et Mme Rimendetout ont une fille : Odette
M et Mme Rinkikoule ont une fille : Tatania
M et Mme Rouquipu ont une fille : Yacinthe
M et Mme Saerdouze ont un fils : Igor
M et Mme Saerdouze ont un fils : Ivan
M et Mme Satum' Faimal ont une fille : Pacome
M et Mme Scott ont une fille : Adèle
M et Mme Scrootdanlsac ont une fille : Jessica
M et Mme Serre ont un fils : Pierre
M et Mme Settofray ont une fille : Mélanie
M et Mme Sexuellement ont un fils et une fille : Kim Marcelle
M et Mme Sifflercetrain on un fils : Jonathan
M et Mme Sinmalohalanagecestpasdlatarte ont un fils : Ferdinand
M et Mme Smoalplancher ont une fille : Déborah
M et Mme Sonlinge ont un fils : Gaetan
M et Mme Sontrocteur ont un fils : Igor
M et Mme Stant-Meme ont un fils : Alain
M et Mme Taimindla ont un fils : Charlotte
M et Mme Talaron ont une fille : Delphine
M et Mme Tamunetabletdeuchocolat ont fils : Jean
M et Mme Tart'Inn ont un fils : Kimberley
M et Mme Tassiepa ont un fils : Sanchez
M et Mme Taukilaibon ont une fille : Olga
M et Mme Tefarssi ont un fils : Thomas
M et Mme Temouille ont un fils : Sacha
M et Mme Tennis Hissonhou ont un fils : Aimé
M et Mme Teupu ont une fille : Macha
M et Mme Tergeist ont un fils : Paul
M et Mme Térieur ont deux fils : Alex et Alain.
M et Mme Teurdeutex ont un fils : Eddy
M et Mme Teusemanies ont un fils : Gédéon
M et Mme Titegoute ont trois filles : Anne, Corinne, Justine
M et Mme Tizamor ont un fils : Géraud
M et Mme Toiletrou ont une fille : Ginette
M et Mme Tombale ont un fils : Pierre
M et Mme Touille ont un fils : Sacha
M et Mme Tounet ont un fils : Patrice
M et Mme Tousseul ont une fille : Sébastienne
M et Mme Unebaffatasoeur ont un fils : Théophile
M et Mme Ussai ont un fils : James
M et Mme Vaisselle ont une fille : Aude
M et Mme Vaistairstalone ont une fille : Cécile
M et Mme Varien ont un fils : Hillary
M et Mme Versairenfamille ont quatre filles : Elsa, Rose, Laure, Annie
M et Mme Villard ont une fille : Hervé
M et Mme Voiturdoccasion ont deux fils : Ivan, Dédé
M et Mme Vrogneboirenpaix ont une fille : Leslie
M et Mme Wailledraille ont un fils : Heinz
M et Mme Xation ont un fils : Luc
M et Mme Yapudbieredanlfrigo ont un fils : Rooooobin
M et Mme Yerrofrais ont un fils : Meleb
M et Mme Zeblouse ont une fille : Agathe
M et Mme Zobarantrai ont un fils : Edmond
M et Mme Deux ont un fils : Jean-Paul
M et Mme Eddy ont un fils : Ken
M et Mme Mauresmo ont un fils : Amélie
M et Mme Mitchel on un fils : Eddy
